DDD->ccc
dDD->wcc
UDD->ffcffcc
uDD->ffwffcc
FDD->fcfffcc
fDD->fwfffcc
RDD->rfcffflcc
rDD->rfwffflcc
BDD->fffcfcc
bDD->fffwfcc
LDD->lfcfffrcc
lDD->lfwfffrcc
DdD->cwc
ddD->wwc
UdD->ffcffwc
udD->ffwffwc
FdD->fcfffwc
fdD->fwfffwc
RdD->rfcffflwc
rdD->rfwffflwc
BdD->fffcfwc
bdD->fffwfwc
LdD->lfcfffrwc
ldD->lfwfffrwc
DUD->cffcffc
dUD->wffcffc
UUD->ffcffffcffc
uUD->c
FUD->fcfffffcffc
fUD->fwfffffcffc
RUD->rfcffflffcffc
rUD->rfwffflffcffc
BUD->fffcfffcffc
bUD->fffwfffcffc
LUD->lfcfffrffcffc
lUD->lfwfffrffcffc
DuD->cffwffc
duD->wffwffc
UuD->c
uuD->ffwffffwffc
FuD->fcfffffwffc
fuD->fwfffffwffc
RuD->rfcffflffwffc
ruD->rfwffflffwffc
BuD->fffcfffwffc
buD->fffwfffwffc
LuD->lfcfffrffwffc
luD->lfwfffrffwffc
DFD->cfcfffc
dFD->wfcfffc
UFD->ffcfffcfffc
uFD->ffwfffcfffc
FFD->fcffffcfffc
fFD->c
RFD->rfcffflfcfffc
rFD->rfwffflfcfffc
BFD->fffcffcfffc
bFD->fffwffcfffc
LFD->lfcfffrfcfffc
lFD->lfwfffrfcfffc
DfD->cfwfffc
dfD->wfwfffc
UfD->ffcfffwfffc
ufD->ffwfffwfffc
FfD->c
ffD->fwffffwfffc
RfD->rfcffflfwfffc
rfD->rfwffflfwfffc
BfD->fffcffwfffc
bfD->fffwffwfffc
LfD->lfcfffrfwfffc
lfD->lfwfffrfwfffc
DRD->crfcffflc
dRD->wrfcffflc
URD->ffcffrfcffflc
uRD->ffwffrfcffflc
FRD->fcfffrfcffflc
fRD->fwfffrfcffflc
RRD->rfcffflrfcffflc
rRD->c
BRD->fffcfrfcffflc
bRD->fffwfrfcffflc
LRD->lfcfffrrfcffflc
lRD->lfwfffrrfcffflc
DrD->crfwffflc
drD->wrfwffflc
UrD->ffcffrfwffflc
urD->ffwffrfwffflc
FrD->fcfffrfwffflc
frD->fwfffrfwffflc
RrD->c
rrD->rfwffflrfwffflc
BrD->fffcfrfwffflc
brD->fffwfrfwffflc
LrD->lfcfffrrfwffflc
lrD->lfwfffrrfwffflc
DBD->cfffcfc
dBD->wfffcfc
UBD->ffcfffffcfc
uBD->ffwfffffcfc
FBD->fcffffffcfc
fBD->fwffffffcfc
RBD->rfcffflfffcfc
rBD->rfwffflfffcfc
BBD->fffcffffcfc
bBD->c
LBD->lfcfffrfffcfc
lBD->lfwfffrfffcfc
DbD->cfffwfc
dbD->wfffwfc
UbD->ffcfffffwfc
ubD->ffwfffffwfc
FbD->fcffffffwfc
fbD->fwffffffwfc
RbD->rfcffflfffwfc
rbD->rfwffflfffwfc
BbD->c
bbD->fffwffffwfc
LbD->lfcfffrfffwfc
lbD->lfwfffrfffwfc
DLD->clfcfffrc
dLD->wlfcfffrc
ULD->ffcfflfcfffrc
uLD->ffwfflfcfffrc
FLD->fcffflfcfffrc
fLD->fwffflfcfffrc
RLD->rfcfffllfcfffrc
rLD->rfwfffllfcfffrc
BLD->fffcflfcfffrc
bLD->fffwflfcfffrc
LLD->lfcfffrlfcfffrc
lLD->c
DlD->clfwfffrc
dlD->wlfwfffrc
UlD->ffcfflfwfffrc
ulD->ffwfflfwfffrc
FlD->fcffflfwfffrc
flD->fwffflfwfffrc
RlD->rfcfffllfwfffrc
rlD->rfwfffllfwfffrc
BlD->fffcflfwfffrc
blD->fffwflfwfffrc
LlD->c
llD->lfwfffrlfwfffrc
DDd->ccw
dDd->wcw
UDd->ffcffcw
uDd->ffwffcw
FDd->fcfffcw
fDd->fwfffcw
RDd->rfcffflcw
rDd->rfwffflcw
BDd->fffcfcw
bDd->fffwfcw
LDd->lfcfffrcw
lDd->lfwfffrcw
Ddd->cww
ddd->www
Udd->ffcffww
udd->ffwffww
Fdd->fcfffww
fdd->fwfffww
Rdd->rfcffflww
rdd->rfwffflww
Bdd->fffcfww
bdd->fffwfww
Ldd->lfcfffrww
ldd->lfwfffrww
DUd->cffcffw
dUd->wffcffw
UUd->ffcffffcffw
uUd->w
FUd->fcfffffcffw
fUd->fwfffffcffw
RUd->rfcffflffcffw
rUd->rfwffflffcffw
BUd->fffcfffcffw
bUd->fffwfffcffw
LUd->lfcfffrffcffw
lUd->lfwfffrffcffw
Dud->cffwffw
dud->wffwffw
Uud->w
uud->ffwffffwffw
Fud->fcfffffwffw
fud->fwfffffwffw
Rud->rfcffflffwffw
rud->rfwffflffwffw
Bud->fffcfffwffw
bud->fffwfffwffw
Lud->lfcfffrffwffw
lud->lfwfffrffwffw
DFd->cfcfffw
dFd->wfcfffw
UFd->ffcfffcfffw
uFd->ffwfffcfffw
FFd->fcffffcfffw
fFd->w
RFd->rfcffflfcfffw
rFd->rfwffflfcfffw
BFd->fffcffcfffw
bFd->fffwffcfffw
LFd->lfcfffrfcfffw
lFd->lfwfffrfcfffw
Dfd->cfwfffw
dfd->wfwfffw
Ufd->ffcfffwfffw
ufd->ffwfffwfffw
Ffd->w
ffd->fwffffwfffw
Rfd->rfcffflfwfffw
rfd->rfwffflfwfffw
Bfd->fffcffwfffw
bfd->fffwffwfffw
Lfd->lfcfffrfwfffw
lfd->lfwfffrfwfffw
DRd->crfcffflw
dRd->wrfcffflw
URd->ffcffrfcffflw
uRd->ffwffrfcffflw
FRd->fcfffrfcffflw
fRd->fwfffrfcffflw
RRd->rfcffflrfcffflw
rRd->w
BRd->fffcfrfcffflw
bRd->fffwfrfcffflw
LRd->lfcfffrrfcffflw
lRd->lfwfffrrfcffflw
Drd->crfwffflw
drd->wrfwffflw
Urd->ffcffrfwffflw
urd->ffwffrfwffflw
Frd->fcfffrfwffflw
frd->fwfffrfwffflw
Rrd->w
rrd->rfwffflrfwffflw
Brd->fffcfrfwffflw
brd->fffwfrfwffflw
Lrd->lfcfffrrfwffflw
lrd->lfwfffrrfwffflw
DBd->cfffcfw
dBd->wfffcfw
UBd->ffcfffffcfw
uBd->ffwfffffcfw
FBd->fcffffffcfw
fBd->fwffffffcfw
RBd->rfcffflfffcfw
rBd->rfwffflfffcfw
BBd->fffcffffcfw
bBd->w
LBd->lfcfffrfffcfw
lBd->lfwfffrfffcfw
Dbd->cfffwfw
dbd->wfffwfw
Ubd->ffcfffffwfw
ubd->ffwfffffwfw
Fbd->fcffffffwfw
fbd->fwffffffwfw
Rbd->rfcffflfffwfw
rbd->rfwffflfffwfw
Bbd->w
bbd->fffwffffwfw
Lbd->lfcfffrfffwfw
lbd->lfwfffrfffwfw
DLd->clfcfffrw
dLd->wlfcfffrw
ULd->ffcfflfcfffrw
uLd->ffwfflfcfffrw
FLd->fcffflfcfffrw
fLd->fwffflfcfffrw
RLd->rfcfffllfcfffrw
rLd->rfwfffllfcfffrw
BLd->fffcflfcfffrw
bLd->fffwflfcfffrw
LLd->lfcfffrlfcfffrw
lLd->w
Dld->clfwfffrw
dld->wlfwfffrw
Uld->ffcfflfwfffrw
uld->ffwfflfwfffrw
Fld->fcffflfwfffrw
fld->fwffflfwfffrw
Rld->rfcfffllfwfffrw
rld->rfwfffllfwfffrw
Bld->fffcflfwfffrw
bld->fffwflfwfffrw
Lld->w
lld->lfwfffrlfwfffrw
DDU->ccffcff
dDU->wcffcff
UDU->ffcffcffcff
uDU->c
FDU->fcfffcffcff
fDU->fwfffcffcff
RDU->rfcffflcffcff
rDU->rfwffflcffcff
BDU->fffcfcffcff
bDU->fffwfcffcff
LDU->lfcfffrcffcff
lDU->lfwfffrcffcff
DdU->cwffcff
ddU->wwffcff
UdU->ffcffwffcff
udU->w
FdU->fcfffwffcff
fdU->fwfffwffcff
RdU->rfcffflwffcff
rdU->rfwffflwffcff
BdU->fffcfwffcff
bdU->fffwfwffcff
LdU->lfcfffrwffcff
ldU->lfwfffrwffcff
DUU->cffcffffcff
dUU->wffcffffcff
UUU->ffwff
uUU->ffcff
FUU->fcfccff
fUU->fwfccff
RUU->rfcfccrff
rUU->rfwfccrff
BUU->fffcfffcffffcff
bUU->fffwfffcffffcff
LUU->lfcfcclff
lUU->lfwfcclff
DuU->c
duU->w
UuU->ffcff
uuU->ffwff
FuU->fcfff
fuU->fwfff
RuU->rfcfrff
ruU->rfwfrff
BuU->fffcf
buU->fffwf
LuU->lfcflff
luU->lfwflff
DFU->cfcfffffcff
dFU->wfcfffffcff
UFU->ffcfffcfffffcff
uFU->ffwfffcfffffcff
FFU->fccfcff
fFU->ffcff
RFU->rfcffflfcfffffcff
rFU->rfwffflfcfffffcff
BFU->fffcffcfffffcff
bFU->fffwffcfffffcff
LFU->lfcfffrfcfffffcff
lFU->lfwfffrfcfffffcff
DfU->cfwfffffcff
dfU->wfwfffffcff
UfU->ffcfffwfffffcff
ufU->ffwfffwfffffcff
FfU->ffcff
ffU->fccfcff
RfU->rfcffflfwfffffcff
rfU->rfwffflfwfffffcff
BfU->fffcffwfffffcff
bfU->fffwffwfffffcff
LfU->lfcfffrfwfffffcff
lfU->lfwfffrfwfffffcff
DRU->crfcffflffcff
dRU->wrfcffflffcff
URU->ffcffrfcffflffcff
uRU->ffwffrfcffflffcff
FRU->fcfffrfcffflffcff
fRU->fwfffrfcffflffcff
RRU->rfccfcrff
rRU->ffcff
BRU->fffcfrfcffflffcff
bRU->fffwfrfcffflffcff
LRU->lfcfffrrfcffflffcff
lRU->lfwfffrrfcffflffcff
DrU->crfwffflffcff
drU->wrfwffflffcff
UrU->ffcffrfwffflffcff
urU->ffwffrfwffflffcff
FrU->fcfffrfwffflffcff
frU->fwfffrfwffflffcff
RrU->ffcff
rrU->rfccfcrff
BrU->fffcfrfwffflffcff
brU->fffwfrfwffflffcff
LrU->lfcfffrrfwffflffcff
lrU->lfwfffrrfwffflffcff
DBU->cfffcfffcff
dBU->wfffcfffcff
UBU->ffcfffffcfffcff
uBU->ffwfffffcfffcff
FBU->fcffffffcfffcff
fBU->fwffffffcfffcff
RBU->rfcffflfffcfffcff
rBU->rfwffflfffcfffcff
BBU->fffcffffcfffcff
bBU->ffcff
LBU->lfcfffrfffcfffcff
lBU->lfwfffrfffcfffcff
DbU->cfffwfffcff
dbU->wfffwfffcff
UbU->ffcfffffwfffcff
ubU->ffwfffffwfffcff
FbU->fcffffffwfffcff
fbU->fwffffffwfffcff
RbU->rfcffflfffwfffcff
rbU->rfwffflfffwfffcff
BbU->ffcff
bbU->fffwffffwfffcff
LbU->lfcfffrfffwfffcff
lbU->lfwfffrfffwfffcff
DLU->clfcfffrffcff
dLU->wlfcfffrffcff
ULU->ffcfflfcfffrffcff
uLU->ffwfflfcfffrffcff
FLU->fcffflfcfffrffcff
fLU->fwffflfcfffrffcff
RLU->rfcfffllfcfffrffcff
rLU->rfwfffllfcfffrffcff
BLU->fffcflfcfffrffcff
bLU->fffwflfcfffrffcff
LLU->lfccfclff
lLU->ffcff
DlU->clfwfffrffcff
dlU->wlfwfffrffcff
UlU->ffcfflfwfffrffcff
ulU->ffwfflfwfffrffcff
FlU->fcffflfwfffrffcff
flU->fwffflfwfffrffcff
RlU->rfcfffllfwfffrffcff
rlU->rfwfffllfwfffrffcff
BlU->fffcflfwfffrffcff
blU->fffwflfwfffrffcff
LlU->ffcff
llU->lfccfclff
DDu->ccffwff
dDu->wcffwff
UDu->c
uDu->ffwffcffwff
FDu->fcfffcffwff
fDu->fwfffcffwff
RDu->rfcffflcffwff
rDu->rfwffflcffwff
BDu->fffcfcffwff
bDu->fffwfcffwff
LDu->lfcfffrcffwff
lDu->lfwfffrcffwff
Ddu->cwffwff
ddu->wwffwff
Udu->w
udu->ffwffwffwff
Fdu->fcfffwffwff
fdu->fwfffwffwff
Rdu->rfcffflwffwff
rdu->rfwffflwffwff
Bdu->fffcfwffwff
bdu->fffwfwffwff
Ldu->lfcfffrwffwff
ldu->lfwfffrwffwff
DUu->c
dUu->w
UUu->ffcff
uUu->ffwff
FUu->fcfff
fUu->fwfff
RUu->rfcfrff
rUu->rfwfrff
BUu->fffcf
bUu->fffwf
LUu->lfcflff
lUu->lfwflff
Duu->cffwffffwff
duu->wffwffffwff
Uuu->ffwff
uuu->ffcff
Fuu->fcfccff
fuu->fwfccff
Ruu->rfcfccrff
ruu->rfwfccrff
Buu->fffcfffwffffwff
buu->fffwfffwffffwff
Luu->lfcfcclff
luu->lfwfcclff
DFu->cfcfffffwff
dFu->wfcfffffwff
UFu->ffcfffcfffffwff
uFu->ffwfffcfffffwff
FFu->fccfwff
fFu->ffwff
RFu->rfcffflfcfffffwff
rFu->rfwffflfcfffffwff
BFu->fffcffcfffffwff
bFu->fffwffcfffffwff
LFu->lfcfffrfcfffffwff
lFu->lfwfffrfcfffffwff
Dfu->cfwfffffwff
dfu->wfwfffffwff
Ufu->ffcfffwfffffwff
ufu->ffwfffwfffffwff
Ffu->ffwff
ffu->fccfwff
Rfu->rfcffflfwfffffwff
rfu->rfwffflfwfffffwff
Bfu->fffcffwfffffwff
bfu->fffwffwfffffwff
Lfu->lfcfffrfwfffffwff
lfu->lfwfffrfwfffffwff
DRu->crfcffflffwff
dRu->wrfcffflffwff
URu->ffcffrfcffflffwff
uRu->ffwffrfcffflffwff
FRu->fcfffrfcffflffwff
fRu->fwfffrfcffflffwff
RRu->rfccfwrff
rRu->ffwff
BRu->fffcfrfcffflffwff
bRu->fffwfrfcffflffwff
LRu->lfcfffrrfcffflffwff
lRu->lfwfffrrfcffflffwff
Dru->crfwffflffwff
dru->wrfwffflffwff
Uru->ffcffrfwffflffwff
uru->ffwffrfwffflffwff
Fru->fcfffrfwffflffwff
fru->fwfffrfwffflffwff
Rru->ffwff
rru->rfccfwrff
Bru->fffcfrfwffflffwff
bru->fffwfrfwffflffwff
Lru->lfcfffrrfwffflffwff
lru->lfwfffrrfwffflffwff
DBu->cfffcfffwff
dBu->wfffcfffwff
UBu->ffcfffffcfffwff
uBu->ffwfffffcfffwff
FBu->fcffffffcfffwff
fBu->fwffffffcfffwff
RBu->rfcffflfffcfffwff
rBu->rfwffflfffcfffwff
BBu->fffcffffcfffwff
bBu->ffwff
LBu->lfcfffrfffcfffwff
lBu->lfwfffrfffcfffwff
Dbu->cfffwfffwff
dbu->wfffwfffwff
Ubu->ffcfffffwfffwff
ubu->ffwfffffwfffwff
Fbu->fcffffffwfffwff
fbu->fwffffffwfffwff
Rbu->rfcffflfffwfffwff
rbu->rfwffflfffwfffwff
Bbu->ffwff
bbu->fffwffffwfffwff
Lbu->lfcfffrfffwfffwff
lbu->lfwfffrfffwfffwff
DLu->clfcfffrffwff
dLu->wlfcfffrffwff
ULu->ffcfflfcfffrffwff
uLu->ffwfflfcfffrffwff
FLu->fcffflfcfffrffwff
fLu->fwffflfcfffrffwff
RLu->rfcfffllfcfffrffwff
rLu->rfwfffllfcfffrffwff
BLu->fffcflfcfffrffwff
bLu->fffwflfcfffrffwff
LLu->lfccfwlff
lLu->ffwff
Dlu->clfwfffrffwff
dlu->wlfwfffrffwff
Ulu->ffcfflfwfffrffwff
ulu->ffwfflfwfffrffwff
Flu->fcffflfwfffrffwff
flu->fwffflfwfffrffwff
Rlu->rfcfffllfwfffrffwff
rlu->rfwfffllfwfffrffwff
Blu->fffcflfwfffrffwff
blu->fffwflfwfffrffwff
Llu->ffwff
llu->lfccfwlff
DDF->ccfcfff
dDF->wcfcfff
UDF->ffcffcfcfff
uDF->ffwffcfcfff
FDF->fcfffcfcfff
fDF->fwfffcfcfff
RDF->rfcffflcfcfff
rDF->rfwffflcfcfff
BDF->fffcfcfcfff
bDF->fffwfcfcfff
LDF->lfcfffrcfcfff
lDF->lfwfffrcfcfff
DdF->cwfcfff
ddF->wwfcfff
UdF->ffcffwfcfff
udF->ffwffwfcfff
FdF->fcfffwfcfff
fdF->fwfffwfcfff
RdF->rfcffflwfcfff
rdF->rfwffflwfcfff
BdF->fffcfwfcfff
bdF->fffwfwfcfff
LdF->lfcfffrwfcfff
ldF->lfwfffrwfcfff
DUF->cffcfffcfff
dUF->wffcfffcfff
UUF->ffcffffcfffcfff
uUF->fcfff
FUF->fcfffffcfffcfff
fUF->fwfffffcfffcfff
RUF->rfcffflffcfffcfff
rUF->rfwffflffcfffcfff
BUF->fffcfffcfffcfff
bUF->fffwfffcfffcfff
LUF->lfcfffrffcfffcfff
lUF->lfwfffrffcfffcfff
DuF->cffwfffcfff
duF->wffwfffcfff
UuF->fcfff
uuF->ffwffffwfffcfff
FuF->fcfffffwfffcfff
fuF->fwfffffwfffcfff
RuF->rfcffflffwfffcfff
ruF->rfwffflffwfffcfff
BuF->fffcfffwfffcfff
buF->fffwfffwfffcfff
LuF->lfcfffrffwfffcfff
luF->lfwfffrffwfffcfff
DFF->cfcffffcfff
dFF->wfcffffcfff
UFF->ffcfffcffffcfff
uFF->ffwfffcffffcfff
FFF->fwfff
fFF->fcfff
RFF->rfcffflfcffffcfff
rFF->rfwffflfcffffcfff
BFF->fccffcf
bFF->fccffwf
LFF->lfcfffrfcffffcfff
lFF->lfwfffrfcffffcfff
DfF->c
dfF->w
UfF->ffcff
ufF->ffwff
FfF->fcfff
ffF->fwfff
RfF->rfcfrff
rfF->rfwfrff
BfF->fffcf
bfF->fffwf
LfF->lfcflff
lfF->lfwflff
DRF->crfcffflfcfff
dRF->wrfcffflfcfff
URF->ffcffrfcffflfcfff
uRF->ffwffrfcffflfcfff
FRF->fcfffrfcffflfcfff
fRF->fwfffrfcffflfcfff
RRF->rfcffflrfcffflfcfff
rRF->fcfff
BRF->fffcfrfcffflfcfff
bRF->fffwfrfcffflfcfff
LRF->lfcfffrrfcffflfcfff
lRF->lfwfffrrfcffflfcfff
DrF->crfwffflfcfff
drF->wrfwffflfcfff
UrF->ffcffrfwffflfcfff
urF->ffwffrfwffflfcfff
FrF->fcfffrfwffflfcfff
frF->fwfffrfwffflfcfff
RrF->fcfff
rrF->rfwffflrfwffflfcfff
BrF->fffcfrfwffflfcfff
brF->fffwfrfwffflfcfff
LrF->lfcfffrrfwffflfcfff
lrF->lfwfffrrfwffflfcfff
DBF->cfffcffcfff
dBF->wfffcffcfff
UBF->ffcfffffcffcfff
uBF->ffwfffffcffcfff
FBF->fccffcf
fBF->fffcf
RBF->rfcffflfffcffcfff
rBF->rfwffflfffcffcfff
BBF->fcffccf
bBF->fcfff
LBF->lfcfffrfffcffcfff
lBF->lfwfffrfffcffcfff
DbF->cfffwffcfff
dbF->wfffwffcfff
UbF->ffcfffffwffcfff
ubF->ffwfffffwffcfff
FbF->fccffwf
fbF->fffwf
RbF->rfcffflfffwffcfff
rbF->rfwffflfffwffcfff
BbF->fcfff
bbF->fcffccf
LbF->lfcfffrfffwffcfff
lbF->lfwfffrfffwffcfff
DLF->clfcfffrfcfff
dLF->wlfcfffrfcfff
ULF->ffcfflfcfffrfcfff
uLF->ffwfflfcfffrfcfff
FLF->fcffflfcfffrfcfff
fLF->fwffflfcfffrfcfff
RLF->rfcfffllfcfffrfcfff
rLF->rfwfffllfcfffrfcfff
BLF->fffcflfcfffrfcfff
bLF->fffwflfcfffrfcfff
LLF->lfcfffrlfcfffrfcfff
lLF->fcfff
DlF->clfwfffrfcfff
dlF->wlfwfffrfcfff
UlF->ffcfflfwfffrfcfff
ulF->ffwfflfwfffrfcfff
FlF->fcffflfwfffrfcfff
flF->fwffflfwfffrfcfff
RlF->rfcfffllfwfffrfcfff
rlF->rfwfffllfwfffrfcfff
BlF->fffcflfwfffrfcfff
blF->fffwflfwfffrfcfff
LlF->fcfff
llF->lfwfffrlfwfffrfcfff
DDf->ccfwfff
dDf->wcfwfff
UDf->ffcffcfwfff
uDf->ffwffcfwfff
FDf->fcfffcfwfff
fDf->fwfffcfwfff
RDf->rfcffflcfwfff
rDf->rfwffflcfwfff
BDf->fffcfcfwfff
bDf->fffwfcfwfff
LDf->lfcfffrcfwfff
lDf->lfwfffrcfwfff
Ddf->cwfwfff
ddf->wwfwfff
Udf->ffcffwfwfff
udf->ffwffwfwfff
Fdf->fcfffwfwfff
fdf->fwfffwfwfff
Rdf->rfcffflwfwfff
rdf->rfwffflwfwfff
Bdf->fffcfwfwfff
bdf->fffwfwfwfff
Ldf->lfcfffrwfwfff
ldf->lfwfffrwfwfff
DUf->cffcfffwfff
dUf->wffcfffwfff
UUf->ffcffffcfffwfff
uUf->fwfff
FUf->fcfffffcfffwfff
fUf->fwfffffcfffwfff
RUf->rfcffflffcfffwfff
rUf->rfwffflffcfffwfff
BUf->fffcfffcfffwfff
bUf->fffwfffcfffwfff
LUf->lfcfffrffcfffwfff
lUf->lfwfffrffcfffwfff
Duf->cffwfffwfff
duf->wffwfffwfff
Uuf->fwfff
uuf->ffwffffwfffwfff
Fuf->fcfffffwfffwfff
fuf->fwfffffwfffwfff
Ruf->rfcffflffwfffwfff
ruf->rfwffflffwfffwfff
Buf->fffcfffwfffwfff
buf->fffwfffwfffwfff
Luf->lfcfffrffwfffwfff
luf->lfwfffrffwfffwfff
DFf->c
dFf->w
UFf->ffcff
uFf->ffwff
FFf->fcfff
fFf->fwfff
RFf->rfcfrff
rFf->rfwfrff
BFf->fffcf
bFf->fffwf
LFf->lfcflff
lFf->lfwflff
Dff->cfwffffwfff
dff->wfwffffwfff
Uff->ffcfffwffffwfff
uff->ffwfffwffffwfff
Fff->fwfff
fff->fcfff
Rff->rfcffflfwffffwfff
rff->rfwffflfwffffwfff
Bff->fccffcf
bff->fccffwf
Lff->lfcfffrfwffffwfff
lff->lfwfffrfwffffwfff
DRf->crfcffflfwfff
dRf->wrfcffflfwfff
URf->ffcffrfcffflfwfff
uRf->ffwffrfcffflfwfff
FRf->fcfffrfcffflfwfff
fRf->fwfffrfcffflfwfff
RRf->rfcffflrfcffflfwfff
rRf->fwfff
BRf->fffcfrfcffflfwfff
bRf->fffwfrfcffflfwfff
LRf->lfcfffrrfcffflfwfff
lRf->lfwfffrrfcffflfwfff
Drf->crfwffflfwfff
drf->wrfwffflfwfff
Urf->ffcffrfwffflfwfff
urf->ffwffrfwffflfwfff
Frf->fcfffrfwffflfwfff
frf->fwfffrfwffflfwfff
Rrf->fwfff
rrf->rfwffflrfwffflfwfff
Brf->fffcfrfwffflfwfff
brf->fffwfrfwffflfwfff
Lrf->lfcfffrrfwffflfwfff
lrf->lfwfffrrfwffflfwfff
DBf->cfffcffwfff
dBf->wfffcffwfff
UBf->ffcfffffcffwfff
uBf->ffwfffffcffwfff
FBf->fffcf
fBf->fccffcf
RBf->rfcffflfffcffwfff
rBf->rfwffflfffcffwfff
BBf->fwffccf
bBf->fwfff
LBf->lfcfffrfffcffwfff
lBf->lfwfffrfffcffwfff
Dbf->cfffwffwfff
dbf->wfffwffwfff
Ubf->ffcfffffwffwfff
ubf->ffwfffffwffwfff
Fbf->fffwf
fbf->fccffwf
Rbf->rfcffflfffwffwfff
rbf->rfwffflfffwffwfff
Bbf->fwfff
bbf->fwffccf
Lbf->lfcfffrfffwffwfff
lbf->lfwfffrfffwffwfff
DLf->clfcfffrfwfff
dLf->wlfcfffrfwfff
ULf->ffcfflfcfffrfwfff
uLf->ffwfflfcfffrfwfff
FLf->fcffflfcfffrfwfff
fLf->fwffflfcfffrfwfff
RLf->rfcfffllfcfffrfwfff
rLf->rfwfffllfcfffrfwfff
BLf->fffcflfcfffrfwfff
bLf->fffwflfcfffrfwfff
LLf->lfcfffrlfcfffrfwfff
lLf->fwfff
Dlf->clfwfffrfwfff
dlf->wlfwfffrfwfff
Ulf->ffcfflfwfffrfwfff
ulf->ffwfflfwfffrfwfff
Flf->fcffflfwfffrfwfff
flf->fwffflfwfffrfwfff
Rlf->rfcfffllfwfffrfwfff
rlf->rfwfffllfwfffrfwfff
Blf->fffcflfwfffrfwfff
blf->fffwflfwfffrfwfff
Llf->fwfff
llf->lfwfffrlfwfffrfwfff
DDR->ccrfcfffl
dDR->wcrfcfffl
UDR->ffcffcrfcfffl
uDR->ffwffcrfcfffl
FDR->fcfffcrfcfffl
fDR->fwfffcrfcfffl
RDR->rfcffflcrfcfffl
rDR->rfwffflcrfcfffl
BDR->fffcfcrfcfffl
bDR->fffwfcrfcfffl
LDR->lfcfffrcrfcfffl
lDR->lfwfffrcrfcfffl
DdR->cwrfcfffl
ddR->wwrfcfffl
UdR->ffcffwrfcfffl
udR->ffwffwrfcfffl
FdR->fcfffwrfcfffl
fdR->fwfffwrfcfffl
RdR->rfcffflwrfcfffl
rdR->rfwffflwrfcfffl
BdR->fffcfwrfcfffl
bdR->fffwfwrfcfffl
LdR->lfcfffrwrfcfffl
ldR->lfwfffrwrfcfffl
DUR->cffcffrfcfffl
dUR->wffcffrfcfffl
UUR->ffccrfcfr
uUR->rfcfrff
FUR->fcfcrfcfr
fUR->fwfcrfcfr
RUR->rfcffflffcffrfcfffl
rUR->rfwffflffcffrfcfffl
BUR->fffcfffcffrfcfffl
bUR->fffwfffcffrfcfffl
LUR->lfcfcfcfr
lUR->lfwfcfcfr
DuR->cffwffrfcfffl
duR->wffwffrfcfffl
UuR->rfcfrff
uuR->ffccrfcfr
FuR->fcfwrfcfr
fuR->fwfwrfcfr
RuR->rfcffflffwffrfcfffl
ruR->rfwffflffwffrfcfffl
BuR->fffcfffwffrfcfffl
buR->fffwfffwffrfcfffl
LuR->lfcfwfcfr
luR->lfwfwfcfr
DFR->cfcfffrfcfffl
dFR->wfcfffrfcfffl
UFR->ffcfffcfffrfcfffl
uFR->ffwfffcfffrfcfffl
FFR->fccrfcfrf
fFR->rfcfrff
RFR->rfcffflfcfffrfcfffl
rFR->rfwffflfcfffrfcfffl
BFR->fffcffcfffrfcfffl
bFR->fffwffcfffrfcfffl
LFR->lfcfffrfcfffrfcfffl
lFR->lfwfffrfcfffrfcfffl
DfR->cfwfffrfcfffl
dfR->wfwfffrfcfffl
UfR->ffcfffwfffrfcfffl
ufR->ffwfffwfffrfcfffl
FfR->rfcfrff
ffR->fccrfcfrf
RfR->rfcffflfwfffrfcfffl
rfR->rfwffflfwfffrfcfffl
BfR->fffcffwfffrfcfffl
bfR->fffwffwfffrfcfffl
LfR->lfcfffrfwfffrfcfffl
lfR->lfwfffrfwfffrfcfffl
DRR->crfcffflrfcfffl
dRR->wrfcffflrfcfffl
URR->ffcrfccfr
uRR->ffwrfccfr
FRR->fcrfccfrf
fRR->fwrfccfrf
RRR->rfwfrff
rRR->rfcfrff
BRR->fffcfrfcffflrfcfffl
bRR->fffwfrfcffflrfcfffl
LRR->lfcffccfr
lRR->lfwffccfr
DrR->c
drR->w
UrR->ffcff
urR->ffwff
FrR->fcfff
frR->fwfff
RrR->rfcfrff
rrR->rfwfrff
BrR->fffcf
brR->fffwf
LrR->lfcflff
lrR->lfwflff
DBR->cfffcfrfcfffl
dBR->wfffcfrfcfffl
UBR->ffcfffffcfrfcfffl
uBR->ffwfffffcfrfcfffl
FBR->fcffffffcfrfcfffl
fBR->fwffffffcfrfcfffl
RBR->rfcffflfffcfrfcfffl
rBR->rfwffflfffcfrfcfffl
BBR->fffcffffcfrfcfffl
bBR->rfcfrff
LBR->lfcfffrfffcfrfcfffl
lBR->lfwfffrfffcfrfcfffl
DbR->cfffwfrfcfffl
dbR->wfffwfrfcfffl
UbR->ffcfffffwfrfcfffl
ubR->ffwfffffwfrfcfffl
FbR->fcffffffwfrfcfffl
fbR->fwffffffwfrfcfffl
RbR->rfcffflfffwfrfcfffl
rbR->rfwffflfffwfrfcfffl
BbR->rfcfrff
bbR->fffwffffwfrfcfffl
LbR->lfcfffrfffwfrfcfffl
lbR->lfwfffrfffwfrfcfffl
DLR->clfcfffrrfcfffl
dLR->wlfcfffrrfcfffl
ULR->ffcfflfcfffrrfcfffl
uLR->ffwfflfcfffrrfcfffl
FLR->fcffflfcfffrrfcfffl
fLR->fwffflfcfffrrfcfffl
RLR->lfcffccfr
rLR->lfcflff
BLR->fffcflfcfffrrfcfffl
bLR->fffwflfcfffrrfcfffl
LLR->lfccffcfr
lLR->rfcfrff
DlR->clfwfffrrfcfffl
dlR->wlfwfffrrfcfffl
UlR->ffcfflfwfffrrfcfffl
ulR->ffwfflfwfffrrfcfffl
FlR->fcffflfwfffrrfcfffl
flR->fwffflfwfffrrfcfffl
RlR->lfwffccfr
rlR->lfwflff
BlR->fffcflfwfffrrfcfffl
blR->fffwflfwfffrrfcfffl
LlR->rfcfrff
llR->lfccffcfr
DDr->ccrfwfffl
dDr->wcrfwfffl
UDr->ffcffcrfwfffl
uDr->ffwffcrfwfffl
FDr->fcfffcrfwfffl
fDr->fwfffcrfwfffl
RDr->rfcffflcrfwfffl
rDr->rfwffflcrfwfffl
BDr->fffcfcrfwfffl
bDr->fffwfcrfwfffl
LDr->lfcfffrcrfwfffl
lDr->lfwfffrcrfwfffl
Ddr->cwrfwfffl
ddr->wwrfwfffl
Udr->ffcffwrfwfffl
udr->ffwffwrfwfffl
Fdr->fcfffwrfwfffl
fdr->fwfffwrfwfffl
Rdr->rfcffflwrfwfffl
rdr->rfwffflwrfwfffl
Bdr->fffcfwrfwfffl
bdr->fffwfwrfwfffl
Ldr->lfcfffrwrfwfffl
ldr->lfwfffrwrfwfffl
DUr->cffcffrfwfffl
dUr->wffcffrfwfffl
UUr->ffccrfwfr
uUr->rfwfrff
FUr->fcfcrfwfr
fUr->fwfcrfwfr
RUr->rfcffflffcffrfwfffl
rUr->rfwffflffcffrfwfffl
BUr->fffcfffcffrfwfffl
bUr->fffwfffcffrfwfffl
LUr->lfcfcfwfr
lUr->lfwfcfwfr
Dur->cffwffrfwfffl
dur->wffwffrfwfffl
Uur->rfwfrff
uur->ffccrfwfr
Fur->fcfwrfwfr
fur->fwfwrfwfr
Rur->rfcffflffwffrfwfffl
rur->rfwffflffwffrfwfffl
Bur->fffcfffwffrfwfffl
bur->fffwfffwffrfwfffl
Lur->lfcfwfwfr
lur->lfwfwfwfr
DFr->cfcfffrfwfffl
dFr->wfcfffrfwfffl
UFr->ffcfffcfffrfwfffl
uFr->ffwfffcfffrfwfffl
FFr->fccrfwfrf
fFr->rfwfrff
RFr->rfcffflfcfffrfwfffl
rFr->rfwffflfcfffrfwfffl
BFr->fffcffcfffrfwfffl
bFr->fffwffcfffrfwfffl
LFr->lfcfffrfcfffrfwfffl
lFr->lfwfffrfcfffrfwfffl
Dfr->cfwfffrfwfffl
dfr->wfwfffrfwfffl
Ufr->ffcfffwfffrfwfffl
ufr->ffwfffwfffrfwfffl
Ffr->rfwfrff
ffr->fccrfwfrf
Rfr->rfcffflfwfffrfwfffl
rfr->rfwffflfwfffrfwfffl
Bfr->fffcffwfffrfwfffl
bfr->fffwffwfffrfwfffl
Lfr->lfcfffrfwfffrfwfffl
lfr->lfwfffrfwfffrfwfffl
DRr->c
dRr->w
URr->ffcff
uRr->ffwff
FRr->fcfff
fRr->fwfff
RRr->rfcfrff
rRr->rfwfrff
BRr->fffcf
bRr->fffwf
LRr->lfcflff
lRr->lfwflff
Drr->crfwffflrfwfffl
drr->wrfwffflrfwfffl
Urr->ffcrfccfr
urr->ffwrfccfr
Frr->fcrfccfrf
frr->fwrfccfrf
Rrr->rfwfrff
rrr->rfcfrff
Brr->fffcfrfwffflrfwfffl
brr->fffwfrfwffflrfwfffl
Lrr->lfcffccfr
lrr->lfwffccfr
DBr->cfffcfrfwfffl
dBr->wfffcfrfwfffl
UBr->ffcfffffcfrfwfffl
uBr->ffwfffffcfrfwfffl
FBr->fcffffffcfrfwfffl
fBr->fwffffffcfrfwfffl
RBr->rfcffflfffcfrfwfffl
rBr->rfwffflfffcfrfwfffl
BBr->fffcffffcfrfwfffl
bBr->rfwfrff
LBr->lfcfffrfffcfrfwfffl
lBr->lfwfffrfffcfrfwfffl
Dbr->cfffwfrfwfffl
dbr->wfffwfrfwfffl
Ubr->ffcfffffwfrfwfffl
ubr->ffwfffffwfrfwfffl
Fbr->fcffffffwfrfwfffl
fbr->fwffffffwfrfwfffl
Rbr->rfcffflfffwfrfwfffl
rbr->rfwffflfffwfrfwfffl
Bbr->rfwfrff
bbr->fffwffffwfrfwfffl
Lbr->lfcfffrfffwfrfwfffl
lbr->lfwfffrfffwfrfwfffl
DLr->clfcfffrrfwfffl
dLr->wlfcfffrrfwfffl
ULr->ffcfflfcfffrrfwfffl
uLr->ffwfflfcfffrrfwfffl
FLr->fcffflfcfffrrfwfffl
fLr->fwffflfcfffrrfwfffl
RLr->lfcflff
rLr->lfcffccfr
BLr->fffcflfcfffrrfwfffl
bLr->fffwflfcfffrrfwfffl
LLr->lfccffwfr
lLr->rfwfrff
Dlr->clfwfffrrfwfffl
dlr->wlfwfffrrfwfffl
Ulr->ffcfflfwfffrrfwfffl
ulr->ffwfflfwfffrrfwfffl
Flr->fcffflfwfffrrfwfffl
flr->fwffflfwfffrrfwfffl
Rlr->lfwflff
rlr->lfwffccfr
Blr->fffcflfwfffrrfwfffl
blr->fffwflfwfffrrfwfffl
Llr->rfwfrff
llr->lfccffwfr
DDB->ccfffcf
dDB->wcfffcf
UDB->ffcffcfffcf
uDB->ffwffcfffcf
FDB->fcfffcfffcf
fDB->fwfffcfffcf
RDB->rfcffflcfffcf
rDB->rfwffflcfffcf
BDB->fffcfcfffcf
bDB->fffwfcfffcf
LDB->lfcfffrcfffcf
lDB->lfwfffrcfffcf
DdB->cwfffcf
ddB->wwfffcf
UdB->ffcffwfffcf
udB->ffwffwfffcf
FdB->fcfffwfffcf
fdB->fwfffwfffcf
RdB->rfcffflwfffcf
rdB->rfwffflwfffcf
BdB->fffcfwfffcf
bdB->fffwfwfffcf
LdB->lfcfffrwfffcf
ldB->lfwfffrwfffcf
DUB->cffcfffffcf
dUB->wffcfffffcf
UUB->ffccfcf
uUB->fffcf
FUB->fcfcfcf
fUB->fwfcfcf
RUB->rfcfcrfcf
rUB->rfwfcrfcf
BUB->fffcfffcfffffcf
bUB->fffwfffcfffffcf
LUB->lfcfclfcf
lUB->lfwfclfcf
DuB->cffwfffffcf
duB->wffwfffffcf
UuB->fffcf
uuB->ffccfcf
FuB->fcfwfcf
fuB->fwfwfcf
RuB->rfcfwrfcf
ruB->rfwfwrfcf
BuB->fffcfffwfffffcf
buB->fffwfffwfffffcf
LuB->lfcfwlfcf
luB->lfwfwlfcf
DFB->cfcffffffcf
dFB->wfcffffffcf
UFB->ffcfffcffffffcf
uFB->ffwfffcffffffcf
FFB->fccffcf
fFB->fffcf
RFB->rfcffflfcffffffcf
rFB->rfwffflfcffffffcf
BFB->fcffccf
bFB->fcfff
LFB->lfcfffrfcffffffcf
lFB->lfwfffrfcffffffcf
DfB->cfwffffffcf
dfB->wfwffffffcf
UfB->ffcfffwffffffcf
ufB->ffwfffwffffffcf
FfB->fffcf
ffB->fccffcf
RfB->rfcffflfwffffffcf
rfB->rfwffflfwffffffcf
BfB->fwffccf
bfB->fwfff
LfB->lfcfffrfwffffffcf
lfB->lfwfffrfwffffffcf
DRB->crfcffflfffcf
dRB->wrfcffflfffcf
URB->ffcffrfcffflfffcf
uRB->ffwffrfcffflfffcf
FRB->fcrfcfcrf
fRB->fwrfcfcrf
RRB->rfccrfcrf
rRB->fffcf
BRB->fffcfrfcffflfffcf
bRB->fffwfrfcffflfffcf
LRB->lfcfffrrfcffflfffcf
lRB->lfwfffrrfcffflfffcf
DrB->crfwffflfffcf
drB->wrfwffflfffcf
UrB->ffcffrfwffflfffcf
urB->ffwffrfwffflfffcf
FrB->fcrfwfcrf
frB->fwrfwfcrf
RrB->fffcf
rrB->rfccrfcrf
BrB->fffcfrfwffflfffcf
brB->fffwfrfwffflfffcf
LrB->lfcfffrrfwffflfffcf
lrB->lfwfffrrfwffflfffcf
DBB->cfffcffffcf
dBB->wfffcffffcf
UBB->ffcfccf
uBB->ffwfccf
FBB->fcffccf
fBB->fwffccf
RBB->rfcrfccrf
rBB->rfwrfccrf
BBB->fffwf
bBB->fffcf
LBB->lfclfcclf
lBB->lfwlfcclf
DbB->c
dbB->w
UbB->ffcff
ubB->ffwff
FbB->fcfff
fbB->fwfff
RbB->rfcfrff
rbB->rfwfrff
BbB->fffcf
bbB->fffwf
LbB->lfcflff
lbB->lfwflff
DLB->clfcfffrfffcf
dLB->wlfcfffrfffcf
ULB->ffcfflfcfffrfffcf
uLB->ffwfflfcfffrfffcf
FLB->fclfcfclf
fLB->fwlfcfclf
RLB->rfcfffllfcfffrfffcf
rLB->rfwfffllfcfffrfffcf
BLB->fffcflfcfffrfffcf
bLB->fffwflfcfffrfffcf
LLB->lfcclfclf
lLB->fffcf
DlB->clfwfffrfffcf
dlB->wlfwfffrfffcf
UlB->ffcfflfwfffrfffcf
ulB->ffwfflfwfffrfffcf
FlB->fclfwfclf
flB->fwlfwfclf
RlB->rfcfffllfwfffrfffcf
rlB->rfwfffllfwfffrfffcf
BlB->fffcflfwfffrfffcf
blB->fffwflfwfffrfffcf
LlB->fffcf
llB->lfcclfclf
DDb->ccfffwf
dDb->wcfffwf
UDb->ffcffcfffwf
uDb->ffwffcfffwf
FDb->fcfffcfffwf
fDb->fwfffcfffwf
RDb->rfcffflcfffwf
rDb->rfwffflcfffwf
BDb->fffcfcfffwf
bDb->fffwfcfffwf
LDb->lfcfffrcfffwf
lDb->lfwfffrcfffwf
Ddb->cwfffwf
ddb->wwfffwf
Udb->ffcffwfffwf
udb->ffwffwfffwf
Fdb->fcfffwfffwf
fdb->fwfffwfffwf
Rdb->rfcffflwfffwf
rdb->rfwffflwfffwf
Bdb->fffcfwfffwf
bdb->fffwfwfffwf
Ldb->lfcfffrwfffwf
ldb->lfwfffrwfffwf
DUb->cffcfffffwf
dUb->wffcfffffwf
UUb->ffccfwf
uUb->fffwf
FUb->fcfcfwf
fUb->fwfcfwf
RUb->rfcfcrfwf
rUb->rfwfcrfwf
BUb->fffcfffcfffffwf
bUb->fffwfffcfffffwf
LUb->lfcfclfwf
lUb->lfwfclfwf
Dub->cffwfffffwf
dub->wffwfffffwf
Uub->fffwf
uub->ffccfwf
Fub->fcfwfwf
fub->fwfwfwf
Rub->rfcfwrfwf
rub->rfwfwrfwf
Bub->fffcfffwfffffwf
bub->fffwfffwfffffwf
Lub->lfcfwlfwf
lub->lfwfwlfwf
DFb->cfcffffffwf
dFb->wfcffffffwf
UFb->ffcfffcffffffwf
uFb->ffwfffcffffffwf
FFb->fccffwf
fFb->fffwf
RFb->rfcffflfcffffffwf
rFb->rfwffflfcffffffwf
BFb->fcfff
bFb->fcffccf
LFb->lfcfffrfcffffffwf
lFb->lfwfffrfcffffffwf
Dfb->cfwffffffwf
dfb->wfwffffffwf
Ufb->ffcfffwffffffwf
ufb->ffwfffwffffffwf
Ffb->fffwf
ffb->fccffwf
Rfb->rfcffflfwffffffwf
rfb->rfwffflfwffffffwf
Bfb->fwfff
bfb->fwffccf
Lfb->lfcfffrfwffffffwf
lfb->lfwfffrfwffffffwf
DRb->crfcffflfffwf
dRb->wrfcffflfffwf
URb->ffcffrfcffflfffwf
uRb->ffwffrfcffflfffwf
FRb->fcrfcfwrf
fRb->fwrfcfwrf
RRb->rfccrfwrf
rRb->fffwf
BRb->fffcfrfcffflfffwf
bRb->fffwfrfcffflfffwf
LRb->lfcfffrrfcffflfffwf
lRb->lfwfffrrfcffflfffwf
Drb->crfwffflfffwf
drb->wrfwffflfffwf
Urb->ffcffrfwffflfffwf
urb->ffwffrfwffflfffwf
Frb->fcrfwfwrf
frb->fwrfwfwrf
Rrb->fffwf
rrb->rfccrfwrf
Brb->fffcfrfwffflfffwf
brb->fffwfrfwffflfffwf
Lrb->lfcfffrrfwffflfffwf
lrb->lfwfffrrfwffflfffwf
DBb->c
dBb->w
UBb->ffcff
uBb->ffwff
FBb->fcfff
fBb->fwfff
RBb->rfcfrff
rBb->rfwfrff
BBb->fffcf
bBb->fffwf
LBb->lfcflff
lBb->lfwflff
Dbb->cfffwffffwf
dbb->wfffwffffwf
Ubb->ffcfccf
ubb->ffwfccf
Fbb->fcffccf
fbb->fwffccf
Rbb->rfcrfccrf
rbb->rfwrfccrf
Bbb->fffwf
bbb->fffcf
Lbb->lfclfcclf
lbb->lfwlfcclf
DLb->clfcfffrfffwf
dLb->wlfcfffrfffwf
ULb->ffcfflfcfffrfffwf
uLb->ffwfflfcfffrfffwf
FLb->fclfcfwlf
fLb->fwlfcfwlf
RLb->rfcfffllfcfffrfffwf
rLb->rfwfffllfcfffrfffwf
BLb->fffcflfcfffrfffwf
bLb->fffwflfcfffrfffwf
LLb->lfcclfwlf
lLb->fffwf
Dlb->clfwfffrfffwf
dlb->wlfwfffrfffwf
Ulb->ffcfflfwfffrfffwf
ulb->ffwfflfwfffrfffwf
Flb->fclfwfwlf
flb->fwlfwfwlf
Rlb->rfcfffllfwfffrfffwf
rlb->rfwfffllfwfffrfffwf
Blb->fffcflfwfffrfffwf
blb->fffwflfwfffrfffwf
Llb->fffwf
llb->lfcclfwlf
DDL->cclfcfffr
dDL->wclfcfffr
UDL->ffcffclfcfffr
uDL->ffwffclfcfffr
FDL->fcfffclfcfffr
fDL->fwfffclfcfffr
RDL->rfcffflclfcfffr
rDL->rfwffflclfcfffr
BDL->fffcfclfcfffr
bDL->fffwfclfcfffr
LDL->lfcfffrclfcfffr
lDL->lfwfffrclfcfffr
DdL->cwlfcfffr
ddL->wwlfcfffr
UdL->ffcffwlfcfffr
udL->ffwffwlfcfffr
FdL->fcfffwlfcfffr
fdL->fwfffwlfcfffr
RdL->rfcffflwlfcfffr
rdL->rfwffflwlfcfffr
BdL->fffcfwlfcfffr
bdL->fffwfwlfcfffr
LdL->lfcfffrwlfcfffr
ldL->lfwfffrwlfcfffr
DUL->cffcfflfcfffr
dUL->wffcfflfcfffr
UUL->ffcclfcfl
uUL->lfcflff
FUL->fcfclfcfl
fUL->fwfclfcfl
RUL->rfcfcfcfl
rUL->rfwfcfcfl
BUL->fffcfffcfflfcfffr
bUL->fffwfffcfflfcfffr
LUL->lfcfffrffcfflfcfffr
lUL->lfwfffrffcfflfcfffr
DuL->cffwfflfcfffr
duL->wffwfflfcfffr
UuL->lfcflff
uuL->ffcclfcfl
FuL->fcfwlfcfl
fuL->fwfwlfcfl
RuL->rfcfwfcfl
ruL->rfwfwfcfl
BuL->fffcfffwfflfcfffr
buL->fffwfffwfflfcfffr
LuL->lfcfffrffwfflfcfffr
luL->lfwfffrffwfflfcfffr
DFL->cfcffflfcfffr
dFL->wfcffflfcfffr
UFL->ffcfffcffflfcfffr
uFL->ffwfffcffflfcfffr
FFL->fcclfcflf
fFL->lfcflff
RFL->rfcffflfcffflfcfffr
rFL->rfwffflfcffflfcfffr
BFL->fffcffcffflfcfffr
bFL->fffwffcffflfcfffr
LFL->lfcfffrfcffflfcfffr
lFL->lfwfffrfcffflfcfffr
DfL->cfwffflfcfffr
dfL->wfwffflfcfffr
UfL->ffcfffwffflfcfffr
ufL->ffwfffwffflfcfffr
FfL->lfcflff
ffL->fcclfcflf
RfL->rfcffflfwffflfcfffr
rfL->rfwffflfwffflfcfffr
BfL->fffcffwffflfcfffr
bfL->fffwffwffflfcfffr
LfL->lfcfffrfwffflfcfffr
lfL->lfwfffrfwffflfcfffr
DRL->crfcfffllfcfffr
dRL->wrfcfffllfcfffr
URL->ffcffrfcfffllfcfffr
uRL->ffwffrfcfffllfcfffr
FRL->fcfffrfcfffllfcfffr
fRL->fwfffrfcfffllfcfffr
RRL->lfcffccfr
rRL->lfcflff
BRL->fffcfrfcfffllfcfffr
bRL->fffwfrfcfffllfcfffr
LRL->lfccffcfr
lRL->rfcfrff
DrL->crfwfffllfcfffr
drL->wrfwfffllfcfffr
UrL->ffcffrfwfffllfcfffr
urL->ffwffrfwfffllfcfffr
FrL->fcfffrfwfffllfcfffr
frL->fwfffrfwfffllfcfffr
RrL->lfcflff
rrL->lfcffccfr
BrL->fffcfrfwfffllfcfffr
brL->fffwfrfwfffllfcfffr
LrL->lfccffwfr
lrL->rfwfrff
DBL->cfffcflfcfffr
dBL->wfffcflfcfffr
UBL->ffcfffffcflfcfffr
uBL->ffwfffffcflfcfffr
FBL->fcffffffcflfcfffr
fBL->fwffffffcflfcfffr
RBL->rfcffflfffcflfcfffr
rBL->rfwffflfffcflfcfffr
BBL->fffcffffcflfcfffr
bBL->lfcflff
LBL->lfcfffrfffcflfcfffr
lBL->lfwfffrfffcflfcfffr
DbL->cfffwflfcfffr
dbL->wfffwflfcfffr
UbL->ffcfffffwflfcfffr
ubL->ffwfffffwflfcfffr
FbL->fcffffffwflfcfffr
fbL->fwffffffwflfcfffr
RbL->rfcffflfffwflfcfffr
rbL->rfwffflfffwflfcfffr
BbL->lfcflff
bbL->fffwffffwflfcfffr
LbL->lfcfffrfffwflfcfffr
lbL->lfwfffrfffwflfcfffr
DLL->clfcfffrlfcfffr
dLL->wlfcfffrlfcfffr
ULL->ffclfccfl
uLL->ffwlfccfl
FLL->fclfccflf
fLL->fwlfccflf
RLL->lfccffcfr
rLL->lfccffwfr
BLL->fffcflfcfffrlfcfffr
bLL->fffwflfcfffrlfcfffr
LLL->lfwflff
lLL->lfcflff
DlL->c
dlL->w
UlL->ffcff
ulL->ffwff
FlL->fcfff
flL->fwfff
RlL->rfcfrff
rlL->rfwfrff
BlL->fffcf
blL->fffwf
LlL->lfcflff
llL->lfwflff
DDl->cclfwfffr
dDl->wclfwfffr
UDl->ffcffclfwfffr
uDl->ffwffclfwfffr
FDl->fcfffclfwfffr
fDl->fwfffclfwfffr
RDl->rfcffflclfwfffr
rDl->rfwffflclfwfffr
BDl->fffcfclfwfffr
bDl->fffwfclfwfffr
LDl->lfcfffrclfwfffr
lDl->lfwfffrclfwfffr
Ddl->cwlfwfffr
ddl->wwlfwfffr
Udl->ffcffwlfwfffr
udl->ffwffwlfwfffr
Fdl->fcfffwlfwfffr
fdl->fwfffwlfwfffr
Rdl->rfcffflwlfwfffr
rdl->rfwffflwlfwfffr
Bdl->fffcfwlfwfffr
bdl->fffwfwlfwfffr
Ldl->lfcfffrwlfwfffr
ldl->lfwfffrwlfwfffr
DUl->cffcfflfwfffr
dUl->wffcfflfwfffr
UUl->ffcclfwfl
uUl->lfwflff
FUl->fcfclfwfl
fUl->fwfclfwfl
RUl->rfcfcfwfl
rUl->rfwfcfwfl
BUl->fffcfffcfflfwfffr
bUl->fffwfffcfflfwfffr
LUl->lfcfffrffcfflfwfffr
lUl->lfwfffrffcfflfwfffr
Dul->cffwfflfwfffr
dul->wffwfflfwfffr
Uul->lfwflff
uul->ffcclfwfl
Ful->fcfwlfwfl
ful->fwfwlfwfl
Rul->rfcfwfwfl
rul->rfwfwfwfl
Bul->fffcfffwfflfwfffr
bul->fffwfffwfflfwfffr
Lul->lfcfffrffwfflfwfffr
lul->lfwfffrffwfflfwfffr
DFl->cfcffflfwfffr
dFl->wfcffflfwfffr
UFl->ffcfffcffflfwfffr
uFl->ffwfffcffflfwfffr
FFl->fcclfwflf
fFl->lfwflff
RFl->rfcffflfcffflfwfffr
rFl->rfwffflfcffflfwfffr
BFl->fffcffcffflfwfffr
bFl->fffwffcffflfwfffr
LFl->lfcfffrfcffflfwfffr
lFl->lfwfffrfcffflfwfffr
Dfl->cfwffflfwfffr
dfl->wfwffflfwfffr
Ufl->ffcfffwffflfwfffr
ufl->ffwfffwffflfwfffr
Ffl->lfwflff
ffl->fcclfwflf
Rfl->rfcffflfwffflfwfffr
rfl->rfwffflfwffflfwfffr
Bfl->fffcffwffflfwfffr
bfl->fffwffwffflfwfffr
Lfl->lfcfffrfwffflfwfffr
lfl->lfwfffrfwffflfwfffr
DRl->crfcfffllfwfffr
dRl->wrfcfffllfwfffr
URl->ffcffrfcfffllfwfffr
uRl->ffwffrfcfffllfwfffr
FRl->fcfffrfcfffllfwfffr
fRl->fwfffrfcfffllfwfffr
RRl->lfwffccfr
rRl->lfwflff
BRl->fffcfrfcfffllfwfffr
bRl->fffwfrfcfffllfwfffr
LRl->rfcfrff
lRl->lfccffcfr
Drl->crfwfffllfwfffr
drl->wrfwfffllfwfffr
Url->ffcffrfwfffllfwfffr
url->ffwffrfwfffllfwfffr
Frl->fcfffrfwfffllfwfffr
frl->fwfffrfwfffllfwfffr
Rrl->lfwflff
rrl->lfwffccfr
Brl->fffcfrfwfffllfwfffr
brl->fffwfrfwfffllfwfffr
Lrl->rfwfrff
lrl->lfccffwfr
DBl->cfffcflfwfffr
dBl->wfffcflfwfffr
UBl->ffcfffffcflfwfffr
uBl->ffwfffffcflfwfffr
FBl->fcffffffcflfwfffr
fBl->fwffffffcflfwfffr
RBl->rfcffflfffcflfwfffr
rBl->rfwffflfffcflfwfffr
BBl->fffcffffcflfwfffr
bBl->lfwflff
LBl->lfcfffrfffcflfwfffr
lBl->lfwfffrfffcflfwfffr
Dbl->cfffwflfwfffr
dbl->wfffwflfwfffr
Ubl->ffcfffffwflfwfffr
ubl->ffwfffffwflfwfffr
Fbl->fcffffffwflfwfffr
fbl->fwffffffwflfwfffr
Rbl->rfcffflfffwflfwfffr
rbl->rfwffflfffwflfwfffr
Bbl->lfwflff
bbl->fffwffffwflfwfffr
Lbl->lfcfffrfffwflfwfffr
lbl->lfwfffrfffwflfwfffr
DLl->c
dLl->w
ULl->ffcff
uLl->ffwff
FLl->fcfff
fLl->fwfff
RLl->rfcfrff
rLl->rfwfrff
BLl->fffcf
bLl->fffwf
LLl->lfcflff
lLl->lfwflff
Dll->clfwfffrlfwfffr
dll->wlfwfffrlfwfffr
Ull->ffclfccfl
ull->ffwlfccfl
Fll->fclfccflf
fll->fwlfccflf
Rll->lfccffcfr
rll->lfccffwfr
Bll->fffcflfwfffrlfwfffr
bll->fffwflfwfffrlfwfffr
Lll->lfwflff
lll->lfcflff
